11111111111111111111
00000000011111111111
11111111011111111111
11111111011111111111
11111111000000000111
11111111111111110111
11111111111111110111
11111111111111110111
11111111111111110111
11111111111111110111
11100000000000000111
11101111111111111111
11101111111111111111
11101111111111111111
11100000000000000011
11111111111111111011
11111111111111111011
11111111111111111011
11111111111111111000
11111111111111111111